#Linea 1|27
SP|San Pablo|5
NP|Neptuno|
PJ|Pajaritos|
LR|Las Rejas|
EC|Ecuador|
AH|San Alberto Hurtado|
US|Universidad de Santiago|
EL|Estación Central|
LA|ULA|
RP|República|
LH|Los Héroes|2
LM|La Moneda|
CH|Universidad de Chile|
SL|Santa Lucía|
UC|Universidad Católica|
BA|Baquedano|5
SA|Salvador|
MM|Manuel Montt|
PV|Pedro de Valdivia|
LE|Los Leones|6
TB|Tobalaba|4
GO|El Golf|
AL|Alcántara|
EM|Escuela Militar|
MQ|Manquehue|
HM|Hernando de Magallanes|
LD|Los Dominicos|
#Linea 2|22
LC|La Cisterna|4a
EP|El Parrón|
LO|Lo Ovalle|
CN|Ciudad del Niño|
DE|Departamental|
LV|Lo Vial|
SM|San Miguel|
LL|El Llano|
FR|Franklin|6
RO|Rondizzoni|
PQ|Parque O'Higgins|
TO|Toesca|
HE|Los Héroes|1
AN|Santa Ana|5
CA|Puente Cal y Canto|
PT|Patronato|
CB|Cerro Blanco|
CE|Cementerios|
EI|Einstein|
DO|Dorsal|
ZA|Zapadores|
AV|Vespucio Norte|
#Linea 4|23
TOB|Tobalaba|1
COL|Cristóbal Colón|
BIL|Francisco Bilbao|
PDG|Principe de Gales|
SBO|Simón Bolivar|
PEG|Plaza Egaña|
LOR|Los Orientales|
RGR|Grecia|
LPR|Los Presidentes|
RQU|Quilín|
LTO|Las Torres|
MAC|Macul|
VMA|Vicuña Mackenna|4a
VVA|Vicente Valdés|5
RMA|Rojas Magallanes|
TRI|Trinidad|
SJE|San José de la Estrella|
LQU|Los Quillayes|
ECO|Elisa Correa|
HSR|Hospital Sótero del Rio|
LME|Las Mercedes|
PIN|Protectora de la Infancia|
PPA|Plaza de Puente Alto|
#Linea 4a|6
VIM|Vicuña Mackenna|4
SJU|Santa Julia|
LGR|La Granja|
SRO|Santa Rosa|
SRA|San Ramón|
LCI|La Cisterna|2
#Linea 5|30
PM|Plaza de Maipú|
SB|Santiago Bueras|
DS|Del Sol|
MT|Monte Tabor|
LP|Las Parcelas|
LS|Laguna Sur|
BR|Barrancas|
PU|Pudahuel|
SO|San Pablo|1
PR|Lo Prado|
BL|Blanqueado|
GL|Gruta de Lourdes|
QN|Quinta Normal|
RC|Cumming|
NA|Santa Ana|2
PZ|Plaza de Armas|
BE|Bellas Artes|
BQ|Baquedano|1
PB|Parque Bustamante|
SI|Santa Isabel|
IR|Irarrázaval|
NU|Ñuble|6
RA|Rodrigo de Araya|
CV|Carlos Valdovinos|
AG|Camino Agrícola|
SJ|San Joaquín|
PE|Pedrero|
MA|Mirador|
LF|Bellavista de La Florida|
VV|Vicente Valdés|4
#Linea 6|10
CER|Cerrillos|
LVA|Lo Valledor|
PAC|Pedro Aguirre Cerda|
FRA|Franklin|2
BIO|Bío Bío|
NUB|Ñuble|5
ESN|Estadio Nacional|
NUO|Ñuñoa|
ISU|Inés de Suárez|
LEN|Los Leones|1
